30
30
GGGGGGGGGGGGGGGGGGGGGGGGGGGGGG
GGGGG@GGGGGGGGG@GGGGGGGGG@GGGG
GwGGGGGGsGGwGGGGGGsGGwGGGGGGsG
Gw#GGGGGGGGw#GGGGGGGGw#GGGGGGG
Gw#GGGGGGGGw#GGGGGGGGw#GGGGGGG
GwGGGGGGGGGwGGGGGGGGGwGGGGGGGG
GGGGGGG*GGGGGGGGG*GGGGGGGGG*GG
GGGGGGGGGGGGGGGGGGGGGGGGGGGGGG
GGGGGGGGGGGGGGGGGGGGGGGGGGGGGG
GGGGGGGGGGGGGGGGGGGGGGGGGGGGGG
GGGGGGGGGGGGGGGGGGGGGGGGGGGGGG
GGGGG@GGGGGGGGG@GGGGGGGGG@GGGG
GwGGGGGGsGGwGGGGGGsGGwGGGGGGsG
Gw#GGGGGGGGw#GGGGGGGGw#GGGGGGG
Gw#GGGGGGGGw#GGGGGGGGw#GGGGGGG
GwGGGGGGGGGwGGGGGGGGGwGGGGGGGG
GGGGGGG*GGGGGGGGG*GGGGGGGGG*GG
GGGGGGGGGGGGGGGGGGGGGGGGGGGGGG
GGGGGGGGGGGGGGGGGGGGGGGGGGGGGG
GGGGGGGGGGGGGGGGGGGGGGGGGGGGGG
GGGGGGGGGGGGGGGGGGGGGGGGGGGGGG
GGGGG@GGGGGGGGG@GGGGGGGGG@GGGG
GwGGGGGGsGGwGGGGGGsGGwGGGGGGsG
Gw#GGGGGGGGw#GGGGGGGGw#GGGGGGG
Gw#GGGGGGGGw#GGGGGGGGw#GGGGGGG
GwGGGGGGGGGwGGGGGGGGGwGGGGGGGG
GGGGGGG*GGGGGGGGG*GGGGGGGGG*GG
GGGGGGGGGGGGGGGGGGGGGGGGGGGGGG
GGGGGGGGGGGGGGGGGGGGGGGGGGGGGG
GGGGGGGGGGGGGGGGGGGGGGGGGGGGGG