10
10
GGGGGGGGGG
GGGGG@GGGG
GwGGGGGGsG
Gw#GGGGGGG
Gw#GGGGGGG
GwGGGGGGGG
GGGGGGG*GG
GGGGGGGGGG
GGGGGGGGGG
GGGGGGGGGG